++++++++++++++++++++
+&++++++++++++++++++
++++++++++++++++++++
---------+++++++++++
++++++++++++++++++++
++++++++++++++++++++
+++++++++++---------
++++++++++++++++@+++
++++++++++++++++++++
++++++++++++++++++++
++++++++++++++++++++
++++++++++++++++++++
++++++++++++++++++++
++++++++++++++++++++
++++++++++++++++++++
++++++++++++++++++++
++++++++++++++++++++
------------++++++++
++X+++++++++++++++++
++++++++++++++++++++