++++++++++++++++++++
&+++++++++++++++++++
++++++++++++++++++++
++++++++++++++++++++
+--------+++++++++++
++++++++++++++++++++
++++++++++++++++++++
+++++++++++--------+
++++++++++++++++++++
+++++++++++++++++@++
++++++++++++++++++++
++++++++++++++++++++
++++++++++++++++++++
++++++++++++++++++++
++++++++++++++++++++
++++++++++++++++++++
++--------------++++
++++++++++++++++++++
+X++++++++++++++++++
++++++++++++++++++++