++++++++++++++++++++
++&+++++++++++++++++
++++++++++++++++++++
++++++++++++++++++++
---------+++++++++++
++++++++++++++++++++
++++++++++++++++++++
+++++++++++---------
++++++++++++++++++++
+++++++++++++++++@++
++++++++++++++++++++
++++++++++++++++++++
++++++++++++++++++++
++++++++++++++++++++
++++++++++++++++++++
++++++++++++++++++++
----------------++++
++++++++++++++++++++
+X++++++++++++++++++
++++++++++++++++++++